0 0 0 0 0 0 0 0 0 0 0 0 0 0 0
0 1 1 2 7 1 1 1 1 2 2 2 3 1 0
0 1 2 3 0 0 2 3 0 2 0 2 0 1 0
0 3 1 2 3 3 1 1 1 1 1 0 2 1 0
0 6 0 3 0 0 1 3 3 3 1 2 0 1 0
0 1 3 2 1 0 1 3 2 3 1 0 1 8 0 
0 1 0 2 0 2 1 3 3 3 1 3 0 1 0
0 2 1 3 2 3 8 1 1 1 1 2 1 9 0 
0 3 0 1 0 3 0 2 0 2 3 0 0 1 0
0 3 2 1 3 2 1 1 1 1 1 1 1 1 0
0 0 0 0 0 0 0 0 0 0 0 0 0 0 0 